7,0,1,4;25,18,11,4,5,6,13,20,27,34;24,31,32,33,26,19,12;30,23,16,17,10,3,2,1,0,7,14,21,28,35,42,43,44,45,46,47,48,41;40,39,38,37,36,29,22,15,8,9
8,0,2,4;46,45,44,43,42,34,26,18,19,20,21;28,29,30,31,23,15,7,6,5,4,3,2,1,0,8,16,24,32,40,48,56,57,58,59,60,61,62,63;22,14,13,12,11,10,9,17,25,33,41,49,50,51,52,53,54;55,47,39,38,37,36,35,27
8,0,3,4;28,36,44,52,51,50,49;47,46,38,30,22,14,13,12,11,10,9,17,25;27,35,43,42,41,40,48,56,57,58,59,60,61,62,63;39,31,23,15,7,6,5,4,3,2,1,0,8,16,24,32,33,34,26,18,19,20,21,29,37,45,53,54,55
9,0,4,5;50,49,48,39,30,21,20;8,7,6,15,24,33,42,51,60,59,58,57,56;17,26,35,44,53,62,71,80,79,78,77,76,75,74,73,72,63,54,45,46,47,38,29,28,19,10,11,12,13,22,31,40;16,25,34,43,52,61,70,69,68,67,66,65,64,55;37,36,27,18,9,0,1,2,3,4,5,14,23,32,41
9,0,5,6;60,59,58,57,56,65,74,73,72,63,54;49,48,47,38,29,20,11,12,13,14,15,16,25;40,39,30,21,22,23,24,33,34,35,26,17,8,7,6,5,4,3,2,1,10,19,28,37;50,51,52,61,70,69,68,67,66;75,76,77,78,79,80,71,62,53,44,43,42,41,32,31;64,55,46,45,36,27,18,9,0
10,0,6,6;77,76,75,74,64,54,53;69,79,78,88,87,86,85,84,83,73,63;89,99,98,97,96,95,94,93,92,91,90,80,70,71,61,51,41,31,21,11,12,13,14,15,16,17,18,28,38,48,47;81,82,72,62,52,42,32,22,23,24,25,26,27,37;68,67,66,65,55,45,44,43;33,34,35,36,46,56,57,58,59,49,39,29,19,9,8,7,6,5,4,3,2,1,0,10,20,30,40,50,60
10,0,7,5;98,88,78,68,58,48,38,28,18,17,16,15,14,13,12,11,21,31,41,42,52,62;81,82,83,84,85,75,65,55,45,44,43,53,63;22,32,33,34,35,36,46,56,66,76,86,96,95,94,93,92,91,90,80,70,60,50,40,30,20,10,0,1,2,3,4,5,6,7,8,9,19,29,39,49,59,69,79,89,99;97,87,77,67,57,47,37,27,26,25,24,23;54,64,74,73,72,71,61,51
10,0,8,7;3,2,1,0,10,20,30,40,50,60,70,80,90,91,92,93,94,95,96,97,98,99,89,79,69,68,67,57,47,37,36,35,34,33,43;26,27,28,38,48,58;54,64,74,84,83,82,81;62,61,51,41,31,21,11,12,13,14,4,5,6,7,8,9;71,72,73,63,53,52,42,32,22,23,24,25,15,16,17,18,19,29,39,49,59;44,45,46,56,66,76,77;78,88,87,86,85,75,65,55
10,0,9,7;4,5,15,25,26,36,46,45;71,81,82,83,84,85,75,65;11,21,31,41,51,61,62,72,73,74;64,63,53,52,42,32,22,12,2,1,0,10,20,30,40,50,60,70,80,90,91,92,93,94,95,96,97,98,99,89,79,69,59,49,39,29,19,9,8,7;6,16,17,27,37,47,57,67,77;3,13,14,24,34,35;23,33,43,44,54,55,56,66,76,86,87,88,78,68,58,48,38,28,18
10,0,10,6;67,66,65,64,74,84,85,86,87,88,89,79;82,72,62,52,42,43,33;10,0,1,2,3,4,5,6,7,8,9,19,29,39,49,59,69,68,78,77,76,75;90,80,70,60,50,40,30,20,21,11,12,13,14,15,16,17,18,28,38,48,58,57,56,55;45,46,47,37,27,26,25,24,23,22,32,31,41,51,61,71,81,91,92,93,94,95,96,97,98,99;83,73,63,53,54,44,34,35,36
7,0,11,3;39,32,25,18,17,16,23,30,37,44,43,42,35,28,21,14,7,0,1,2,3,4,5,6,13,20,27,34;24,31,38,45,46,47;48,41,40,33,26,19,12,11,10,9,8,15,22,29,36
8,0,12,5;9,17,25,24,32,40,48,56,57,58,59,60,61,62,63;29,21,20,19,11,3;42,43,44,45,46,38,30,22,14,13,12,4;28,27,26,18,10,2,1,0,8,16;5,6,7,15,23,31,39,47,55,54,53,52,51,50,49,41,33,34,35,36,37
8,0,13,4;42,34,26,18,19,20,21,22,30,38,46,54;36,44,52,60,59,58,57,56,48,40,32,24,16,8,0,1,2,3,4,5,6,7;47,55,63,62,61,53,45,37,29,28,27,35,43,51,50;49,41,33,25,17,9,10,11,12,13,14,15,23,31,39
9,0,14,5;65,56,57,58,59,60,51,42,33,24,23,22,21,20,19,18,9,0,1,2,3,4,5,6,7,8,17,26,35,44,53,62,71,80,79,78,77,76;52,61,70,69,68,67,66,75,74,73,72;27,28,29,30,31,32,41,50,49,48,47,46,55,64,63;43,34,25,16,15,14,13,12,11,10;54,45,36,37,38,39,40
9,0,15,5;17,16,15,14,13,12,11,10,19,28,29,30,31,32,41,50,59;65,66,67,68,69,70,61,52,43,34,25;26,35,44,53,62,71,80,79,78,77,76,75,74,73,64,55,56,57,58,49,40,39,38,37,36,27,18,9,0,1,2,3,4,5,6,7,8;60,51,42,33,24,23,22,21,20;48,47,46,45,54,63,72
10,0,16,5;0,10,20,30,40,41,42,43,44,54,55;71,81,82,83,84,85,86,87,88,78,68,58,48,38,28,18,17,16,15,14,13,3,2,1;36,46,56,66,65,64,63,53,52,51,50;11,21,31,32,33,34,35,45;4,5,6,7,8,9,19,29,39,49,59,69,79,89,99,98,97,96,95,94,93,92,91,90,80,70,60,61,62,72,73,74,75,76,77,67,57,47,37,27,26,25,24,23,22,12
10,0,17,6;72,73,74,75,85,86,87,77,67,68;44,45,46,47,48,49,39,29,19,9,8;88,78,79,69,59,58,57,56,55,54,53,43,33,34,35,36,37,38,28,18,17,7,6;93,92,91,90,80,70,60,50,40,30,20,10,0,1,2,3,4,5,15,16,26,27;89,99,98,97,96,95,94,84,83,82,81,71,61,51,41,31,21,11,12,13,14;25,24,23,22,32,42,52,62,63,64,65,66,76
10,0,18,5;0,1,11,21,31,41,51,61,71,72,73,74,75,76,66,56,46,36,26;32,22,12,2,3,4,5,6,7,8,9,19,29,39,49,59,69,79,89,99;10,20,30,40,50,60,70,80,81,82,83,84,85,86,87,77,67,57,47,37,27;90,91,92,93,94,95,96,97,98,88,78,68,58,48,38,28,18,17,16,15,25,24,34,44,54,53;35,45,55,65,64,63,62,52,42,43,33,23,13,14
10,0,19,7;21,11,12,13,14,24,34,44,54,64;90,80,70,60,50,40,30,20,10,0,1,2,3,4,5,15,25,35,45,55,65;39,49,59,69,79,89,99,98,97,96,95,85,84,83,82,72,62,52,42;32,31,41,51,61,71,81,91,92,93,94;26,16,6,7,8,9,19,29,28,38,48,47,57,67,77,76,75,74,73,63,53,43,33,23,22;86,87,88,78,68,58;66,56,46,36,37,27,17,18
10,0,20,6;32,42,52,53,63,64,65,66,67,57,47,37,27,26,25,24,14,13;11,21,31,41,51,50,60,70,80,90,91,92,93,94,95,96,97,98,99,89,79,69,59,49,39,29,19,9,8,7,6;40,30,20,10,0,1,2,12,22,23,33,34,35,45;43,44,54,55,56,46,36;3,4,5,15,16,17,18,28,38,48,58,68,78,88,87,86,85,84,83,82,81,71;61,62,72,73,74,75,76,77
7,0,21,4;0,1,2,3,10,11,18,25,24,23,30;48,47,46,45,44,43,42,35,28,21,14,7,8,9,16,17;4,5,12,19,26,33,32,31;15,22,29,36,37,38,39,40,41,34,27,20,13,6
8,0,22,4;13,21,20,19,18,26,34,42,50,51,52,53,54,55;49,41,33,25,17,9,10,11,12;63,62,61,60,59,58,57,56,48,40,32,24,16,8,0,1,2,3,4,5,6,14,22,30,29,28,27,35,43,44,45,46,47;36,37,38,39,31,23,15,7
8,0,23,4;36,35,34,26,18,10;20,21,22,23,31,39,47,55,63,62,61,60,59,58,57,56;7,15,14,13,12,11,19,27,28,29,30,38,46,54,53,52,51,50,49,48,40,32,24,16,8,0;37,45,44,43,42,41,33,25,17,9,1,2,3,4,5,6
9,0,24,6;56,57,58,59,50,41,32,33;79,80,71,62,53,44,35,26,17,16,15,14,13,12,21,30;8,7,6,5,4,3,2,11,20,29,38,39;47,48,49,40,31,22,23,24,25,34,43,42,51,60;52,61,70,69,78,77,76,75,74,73,72,63,54,45,36,27,18,9;68,67,66,65,64,55,46,37,28,19,10,1,0
9,0,25,6;0,1,2,3,4,13,14,15,16,25;31,32,33,34,35,26,17,8,7,6,5;60,59,58,57,56,47,38,37,28,27,18;36,45,54,63,72,73,74,75,76,77,78,79,80,71,62,53,44,43,42,41,40;11,12,21,22,23,24;46,55,64,65,66,67,68,69,70,61,52,51,50,49,48,39,30,29,20,19,10,9
10,0,26,5;30,20,10,0,1,2,3,4,5,6,7,8,18,28,38,48,47,57,67,66,65,64,63,62,61,71,81,82,83,84,85,86,87,88,89,79,69;26,25,24,23,22,32,42,52,51;56,55,54,53,43,33,34,35;44,45,46,36,37,27,17,16,15,14,13,12,11,21,31,41,40,50,60,70,80,90,91,92,93,94,95,96,97,98,99;9,19,29,39,49,59,58,68,78,77,76,75,74,73,72
10,0,27,5;27,26,25,24,14,13,12,11,10,20,30,40,50,60,70,80,90,91,92,93,94,95,96,97,98,99,89,79;88,87,86,85,84,83,82,81,71,61,51,41,31,21,22,23,33,43,53,63,64,65,66,67,68;32,42,52,62,72,73,74,75,76,77,78;45,46,47,48,49,39,29,19,9,8,7,6,5,4,3,2,1,0;69,59,58,57,56,55,54,44,34,35,36,37,38,28,18,17,16,15
10,0,28,6;6,7,17,18,28,38,48,58,68,78,88,87,86,85,84,83,82,81,71,61,51,41,31;10,11,12,13,23,33,34,44,54;8,9,19,29,39,49,59,69,79,89,99,98,97,96,95,94,93,92,91,90,80,70,60,50,40,30,20,21,22,32,42,43,53;5,15,16,26,36,46,56,66,65,64,63;27,37,47,57,67,77,76,75,74,73,72,62,52;55,45,35,25,24,14,4,3,2,1,0
10,0,29,6;42,43,44,34,24,14,15;0,1,2,3,4,5,6,16,26,25,35,45,55,54,53,52,51,41,31,32;72,73,74,75,76,77,67,57,47,37,27,17,7,8,9,19,29,39,49,59,69,79,89,99,98,97,96,95,94,93,92,91,90,80,70,60,50,40,30,20,21,22;62,63,64,65,66,56,46,36;18,28,38,48,58,68,78,88,87,86,85,84,83,82,81,71,61;10,11,12,13,23,33
10,0,30,7;22,23,33,43,44,45;32,42,52,53,54,55;72,62,63,64,65,66,56,46,36;16,17,18,28,38,48,58,57;95,96,97,98,99,89,79,69,59,49,39,29,19,9,8,7,6,5,15,25,26,27,37,47;67,77,76,75,74,73,83,82,81,71,61,51,41,31,21,11,12,13;35,34,24,14,4,3,2,1,0,10,20,30,40,50,60,70,80,90,91,92,93,94,84,85,86,87,88,78,68
