8,0,1,4;49,50,42,34,26,27,28,36;35,43,51,59,58,57,56,48;18,19,20,21,29,37,45,44,52,60,61,62,63,55,47,39,31,23,15,7,6,5,4,3,2,1,0,8,16,24,32,40;41,33,25,17,9,10,11,12,13,14,22,30,38,46,54,53
8,0,2,5;56,48,40,32,24,16,8,9,10,11,12,13,21,29,37,45,46,47,39,31,23,15,7;35,43,51,52,53,54,55;38,30,22,14,6,5,4,3,2,1,0;57,49,41,33,25,17,18,19,20,28,36,44;63,62,61,60,59,58,50,42,34,26,27
8,0,3,4;35,27,19,11,3,4,5,6;16,24,32,40,48,56,57,58,59,60,61,62,63,55,47,39,31,23,22,21,29,37,45;8,9,17,25,33,41,49,50,51,52,53,54,46,38,30;7,15,14,13,12,20,28,36,44,43,42,34,26,18,10,2,1,0
8,0,4,5;27,35,43,51,59,60,61,62,54,46;63,55,47,39,38,37,45,53;5,4,3,2,1,0,8,16,24,32,40,48,56,57,58,50,42,34,26,18,19,20,21,22,14;52,44,36,28,29,30,31,23,15,7,6;13,12,11,10,9,17,25,33,41,49
8,0,5,4;12,11,10,9,8,16,24,32,40,48,56,57,58,59,60,61,62,63;35,36,37,29,21,13,5,4,3,2,1,0;6,7,15,23,31,39,47,55,54,53,52,51,50,49,41,33,25,17,18,19,20;14,22,30,38,46,45,44,43,42,34,26,27,28
8,0,6,4;37,45,44,43,42,41,40,32,24,16,8,0,1,2,10,18,26,27,28;9,17,25,33,34,35,36;56,48,49,50,51,52,53,54,46,38,30,22,14,13,12;29,21,20,19,11,3,4,5,6,7,15,23,31,39,47,55,63,62,61,60,59,58,57
8,0,7,4;49,50,51,52,53,54,46,38,30,22,14,13,12,11,10;25,26,27,28,29,37,45,44,43,42,41,40,48,56,57,58,59,60,61,62,63,55,47,39,31,23,15,7,6,5,4;3,2,1,9,17,18,19,20,21;0,8,16,24,32,33,34,35,36
8,0,8,4;23,22,14,13,12,11,10,9,17,25,33,41,49;15,7,6,5,4,3,2,1,0,8,16,24,32,40,48,56,57,58,59,60,61,53,45,44,43,35,27,28,29,30,31,39,47,55,63;21,20,19,18,26,34,42,50,51,52;62,54,46,38,37,36
8,0,9,5;5,13,21,29,28,27;44,45,46,47,39,31,23,15;63,62,61,60,59,58,50,42,34,26,18,19,20,12,4,3,2,1,0,8,16,24,32,40,48,56;7,6,14,22,30,38,37,36,35,43,51,52,53,54,55;11,10,9,17,25,33,41,49,57
8,0,10,5;7,15,14,13,12,11,10,9,17,25,33,41,42;27,28,36,37,45,46;54,53,52,51,50,49,48,40,32,24,16,8,0,1,2,3,4,5,6;44,43,35,34,26,18,19,20,21,22,23,31;29,30,38,39,47,55,63,62,61,60,59,58,57,56
9,0,11,5;2,1,0,9,18,19,28,29,30,31,32,33;48,49,50,51,52,53,44,35,26,17,8,7,6,5,4;27,36,45,54,63,72,73,74,75,76,77,78,79,80,71,62,61,60,59,58,57,56,47,38,39,40,41,42,43,34,25,16,15,14,13,12,3;24,23,22,21,20,11,10;37,46,55,64,65,66,67,68,69,70
9,0,12,6;50,49,40,31,22,13,4,3,2,1,0,9,18,27,36;28,19,10,11,12,21,30,39,48,47;8,7,6,5,14,23,32,41;75,76,77,78,79,80,71,62,53,44,35,26,17,16,15,24,33,42,51,60,59,58,57,56,55,64;25,34,43,52,61,70,69,68,67,66,65,74,73,72;63,54,45,46,37,38,29,20
9,0,13,5;8,17,26,25,34,43,52,61,70,69,68,59,50,41,32,23,14,5,6;20,29,38,47,56,65,66,67;58,57,48,39,30,21,12,11,10,19,28,37,46,55,64,73,74,75,76,77,78,79,80,71,62,53,44,35;60,51,42,33,24,15,16,7;49,40,31,22,13,4,3,2,1,0,9,18,27,36,45,54,63,72
9,0,14,6;55,64,65,74,75,76,77,78,79,80,71,62,53,44,35,34,25,24;69,68,67,66,57,56,47,46,45,54,63,72,73;70,61,60,59,58,49,48,39,38,37,36,27,18,9,0,1,2,3,4,5,6,7,8;20,21,22,23,32,33,42,43,52;26,17,16,15,14,13,12,11,10,19,28;29,30,31,40,41,50,51
9,0,15,5;20,29,38,47,56,57,58,59,60,51,52,43,34,25,16,15,6,5,4,3,2,1,0;71,80,79,78,77,76,75,74,73,72,63,54,45,36,27,18,9,10,11,12,21,22;40,31,32,23,14,13;24,33,42,41,50,49,48,39,30;7,8,17,26,35,44,53,62,61,70,69,68,67,66,65,64,55,46,37,28,19
9,0,16,6;38,39,48,57,58,59,60,61,62,53;49,40,31,30,29,28,37,46,55,64,73,74,75,76,77,78,79,80;42,33,24,15,14,13,12,11,10;19,20,21,22,23,32,41,50,51,52,43,44,35,26,17,8;47,56,65,66,67,68,69,70,71;34,25,16,7,6,5,4,3,2,1,0,9,18,27,36,45,54,63,72
9,0,17,4;40,41,42,43,34,25,16,7;5,6,15,24,33,32,31,30,39,48,49,50,51,52,53,44,35,26,17,8;14,23,22,21,20,29,38,47,56,57,58,59,60,61,62,71,80,79,78,77,76,75,74,73,72,63,54,45,36,27,18,9,0,1,2,3,4;13,12,11,10,19,28,37,46,55,64,65,66,67,68,69,70
9,0,18,5;24,33,34,43,52,61,62,71,80,79,78;53,44,35,26,25,16,15,14,13,12,11,10,19,28,37,46,55,64,65,66,67,58;57,56,47,38,29,20,21,22,23,32;40,41,42,51,60,69,70;31,30,39,48,49,50,59,68,77,76,75,74,73,72,63,54,45,36,27,18,9,0,1,2,3,4,5,6,7,8,17
9,0,19,5;60,59,58,57,56,47,38,29,20,21;39,40,41,32,23,14,5;24,33,42,51,50,49,48;15,16,25,34,43,52,61,70,69,68,67,66,65,64,55,46,37,28,19,10,11,12;30,31,22,13,4,3,2,1,0,9,18,27,36,45,54,63,72,73,74,75,76,77,78,79,80,71,62,53,44,35,26,17,8,7,6
9,0,20,5;63,72,73,74,75,76,77,78,79,70,61,52,43,34,25,16,15,14,13,12,11,10;40,39,38,37,36,27,18,9,0,1,2,3,4,5,6,7,8,17,26,35,44,53,62,71,80;48,49,50,41,32,31,30,29,28;54,55,64,65,66,67,68,69;45,46,47,56,57,58,59,60,51,42,33,24,23,22,21,20,19
10,0,21,6;4,3,2,12,22,32,42,52,53,63,64,65,66;14,13,23,33,43,44,45,35;1,0,10,20,30,40,50,60,70,80,90,91,92,93,94,95,96,97,98,99,89,79,69,59,49,39,29,28,18,17,16,26,36,46,56,55,54;11,21,31,41,51,61,62,72,73,74,75,76,77,67,57,47;34,24,25,15,5,6,7,8,9,19;27,37,38,48,58,68,78,88,87,86,85,84,83,82,81,71
10,0,22,5;99,98,97,96,95,85,75,65,55;27,26,25,24,23,22,32,42,52,62,72,71,81;92,91,90,80,70,60,61,51,41,31,21,11,12,13,14,15,16,17,18,28,38,48,58,68,78,77;93,94,84,74,64,54,44,45,46,56;50,40,30,20,10,0,1,2,3,4,5,6,7,8,9,19,29,39,49,59,69,79,89,88,87,86,76,66,67,57,47,37,36,35,34,33,43,53,63,73,83,82
10,0,23,4;19,18,17,16,26,36,46,56,66,65,64,63;0,10,11,12,13,23,33,32,31;22,21,20,30,40,50,60,70,80,90,91,92,93,94,95,96,97,98,99,89,79,69,59,49,39,29,28,27,37,47,57,67,77,76,75,74,73,72,62,52,53,54,55,45,35,25,15,5,6,7,8,9;1,2,3,4,14,24,34,44,43,42,41,51,61,71,81,82,83,84,85,86,87,88,78,68,58,48,38
10,0,24,7;33,23,22,21,31,41,51,61,71,81;18,17,27,26,25,15,5,4,3,2,1,0;55,45,46,47,48,49,39,29,19,9,8,7,6,16;78,88,87,86,85,84,83,82,72,62,52;65,66,56,57,58,59,69,79,89,99,98,97,96,95,94,93,92,91,90,80,70,60,50,40,30,20,10,11,12,13,14,24;32,42,43,53,63,73,74,75,76,77,67,68;28,38,37,36,35,34,44,54,64
10,0,25,5;11,21,31,41,51,61,71,81,82,83,84,85,86,87,88,78,68,58;59,49,48,47,57,67,77,76,75,74,73,63,53,43,33,23,13,3,4,5,6,7,8,9,19;72,62,52,42,32,22,12,2,1,0,10,20,30,40,50,60,70,80,90,91,92,93,94,95,96,97,98,99,89,79,69;38,37,36,46,56,66,65,64,54,44,34,24,14,15,16,17,18;39,29,28,27,26,25,35,45,55
10,0,26,5;68,69,59,49,39,29,19,9,8,7,6,5,4,3,2,1,11,21,31,41,51,61,71,81,82,83;98,88,87,86,76,66,56,55,54,44,34,35,36;0,10,20,30,40,50,60,70,80,90,91,92,93,94,84,74,73,72,62,52,42,32,22,12,13,14,15,16,17,27,37,47,46,45;26,25,24,23,33,43,53,63,64,65,75,85,95,96,97;99,89,79,78,77,67,57,58,48,38,28,18
10,0,27,6;44,34,24,23,22,32,42,52,62,63,73,83,93,94,95,96,97,98,99;18,28,38,48,58,68,78,77,76;81,71,61,51,41,31,21,11,12,13,14,15,25,35,45;85,75,65,55,56,46,36,26,16,6,5,4,3,2,1,0,10,20,30,40,50,60,70,80,90,91,92,82,72;66,67,57,47,37,27,17,7,8,9,19,29,39,49,59,69,79,89,88,87,86;84,74,64,54,53,43,33
10,0,28,6;56,46,36,26,16,17,18,28,38,48,49,59,69,79,89,99,98,97,96,95,94,93,92,91,90,80,70,60,50,40,30,20,21,22;39,29,19,9,8,7,6,5,15,25,35,45,55,54,53,63;62,52,42,43,44,34,24,14,4,3,2,1;66,65,64,74,73,72;58,68,78,88,87,86,85,84,83,82,81,71,61,51,41,31,32,33,23,13,12,11,10,0;27,37,47,57,67,77,76,75
10,0,29,4;90,80,70,71,72,73,74,75,65,55,45;81,91,92,93,94,95,96,97,87,77,67,57,47,37,27,26,25,24,23,33,43,53,52,51,41,31,21,11,1,2,3,4,5,6,7,8,9,19,29,39,49,59,69,79,89,99;0,10,20,30,40,50,60,61,62,63,64,54,44,34,35,36,46,56,66,76,86,85,84,83,82;98,88,78,68,58,48,38,28,18,17,16,15,14,13,12,22,32,42
10,0,30,6;74,75,76,66,56,57;88,78,68,58,48,49,39,29,19,9,8,7,6,5,4,3,2,1,11;59,69,79,89,99,98,97,96,95,94,93,92,82,72,62,52,53,54;14,13,12,22,21,20,10,0;91,81,71,61,51,41,42,43,44,34,35,36,26,27;67,77,87,86,85,84,83,73,63,64,65,55,45,46,47,37,38,28,18,17,16,15,25,24,23,33,32,31,30,40,50,60,70,80,90
