10,0,1,7;45,35,34,24,14,4,3,2,1,0,10,20,21,22;30,40,50,60,70,80,90,91,92,93,94,95,96,97,98,99,89,79,69,59,49,39,29,19,9,8,7,17,27,37;66,65,64,63,53,52,42,32,33,23,13,12,11;43,44,54,55,56;25,15,5;71,81,82,83,84,85,86,87,88,78,68,58,48,38,28,18;6,16,26,36,46,47,57,67,77,76,75,74,73,72,62,61,51,41,31
11,0,2,6;42,41,40,39,38,37,48,59,70,71,72,61,62,63,64,75,86,97,108,107,106,105,104,103,102,101,100,89,78,67,56,45,44,33,22,11,0,1,2,3,4,5,6,7,8,9,10,21;73,84,83,82,81,80,69,58,47,36,25,24;60,49,50,51,52,53;16,17,18,19,20;31,32,43,54,65,76,87,98,109,120,119,118,117,116,115,114,113,112,111,110,99,88,77,66,55;30,29,28,27,26,15,14,13,12,23,34,35,46,57,68,79,90,91,92,93,94,95,96,85,74
12,0,3,7;120,132,133,134,135,136,137,138,139,140,141,142,143,131,119,107,95,83,71,59,47;45,44,43,42,41,40,39,51,63,75;64,52,53,54,55,56,57,58,70,82,94,106,118,130,129,128,127,126,125,124,123,122,121;117,116,115,114,102;33,32,31,30,29,28,27,26,38,50,62,74,86,87,88,76,77,65,66,67,68,69,81,93,105,104,103,91;92,80,79,78,90,89,101,113,112,111,110,109,108,96,84,72,60,48,36,24,12,0,1,2,3,4,5,6,7,8,9,10,11,23,35;46,34,22,21,20,19,18,17,16,15,14,13,25,37,49,61,73,85,97,98,99,100
11,0,4,7;108,97,96,95,94,93,92,91,90,79,68,57;60,49,50,51,52,53,42;76,75,74,73,84,83,82,81,80,69,58,47,46;24,35,36,37,38,39,40,41,30,31;85,86,87,98,109,120,119,118,117,116,115,114,113,112,111,110,99,88,77,66,55,44,33,22,11,0,1,2,3,4,5,6,7,8,9,10;48,59,70,71,72,61,62,63,64,65,54,43,32,21,20,19,18,29,28,27,26,25;17,16,15,14,13,12,23,34,45,56,67,78,89,100,101,102,103,104,105,106,107
10,0,5,7;78,77,76,75,74,73,63,53,52,51,61,71,81,80,90;91,92,93,94,95,96,97,98,99,89,79,69,59,49,39,29,19,9,8,7,6,5,4,3,2;88,87,86,85,84,83,82,72,62;1,11,12,22,23,24,25,26,27,37,47,57,56,55,45,44,43,42,41;54,64,65,66,67,68,58,48,38,28,18,17,16,15,14,13;21,31,32,33,34,35,36,46;0,10,20,30,40,50,60,70
11,0,6,6;65,64,63,62,61,60,59,70;119,120,109,98,87,76,75,74,73,72,71,82,81,80,69,58,47,48,49,50,51,52,53,54,43,32,21,10,9,8,7,6,5,4,3,2,1,0;116,115,114,113,112,111,110,99,88,77,66,55,44,33,22,11,12,13,14,15,16,17,18,19,20,31,42,41;117,118,107,108,97,86,85,84,83,94;40,39,38,37,36,35,46,57,68,79,90,91,92,93;30,29,28,27,26,25,24,23,34,45,56,67,78,89,100,101,102,103,104,105,106,95,96
12,0,7,7;26,27,28,29,30,31,32,20,8,7,6,5,4,3,2,1,0,12,24,36,48,60,72,84,96,108,120,132,133,134,135,136,137,138,139,140,141;91,90,89,88,76,64,65,66,67,68,69,70,71;77,78,79,80,81,82,83,95,107,106,105,117;22,34,46,45,44,43,42,41,40,39,38,50,62,74,86,98,110,111,112,113,114,115,116;130,129,128,127,126,125,124,123,122,121,109,97,85,73,61,49,37,25,13,14,15,16,17,18,19;142,143,131,119,118;33,21,9,10,11,23,35,47,59,58,57,56,55,54,53,52,51,63,75,87,99,100,101,102,103,104,92,93,94
11,0,8,7;78,67,68,69,70,71,72,61,62,51,40,39,28,27,26,25,24,13;19,20,31,42,53,64,75,86,85,96,95,94,93,92,91,102;100,89,90,79,80,81,82,83,84,73,74,63,52,41,30,29,18,17,16,15,14;0,11,22,33,44,45,46,47,48,37,38;97,108,107,106,105,104,103;101,112,111,110,99,88,77,66,55,56,57,58,59,60,49,50;113,114,115,116,117,118,119,120,109,98,87,76,65,54,43,32,21,10,9,8,7,6,5,4,3,2,1,12,23,34,35,36
10,0,9,9;47,46,45,35,34;66,65,64,54,44,43,33,23,24,25,26,27,28;73,72,71,81,91;70,80,90;93,94,95,96,97,98,99,89,79,69,59,49,39,29,19,18,17,16,15,14,13,12,22,32,42,52,51;41,31,21,11;9,8,7,6,5,4,3,2,1,0,10,20,30,40,50,60,61,62,63,53;92,82,83,84,74,75,76,77,67,57,56,55;85,86,87,88,78,68,58,48,38,37,36
11,0,10,8;88,89,90,91,92,93,94,83,84;95,96,85,74,63,52,51,50,61;58,57,46,35,36,25,14,15,16,17,18,19,20,31,32,43,54,65,76,87,98,109,120,119,118,117,116,115,114,113,112,111,110;1,0,11,22,33,44,55,66,77,78,79,80,81,70,59,60,49,38,39,40,41,42,53,64,75,86,97,108,107,106,105,104,103,102,101,100,99;21,10,9,8,7,6,5,4,3,2,13,12;62,73,72,71,82;30,29,28,27,26,37,48,47;69,68,67,56,45,34,23,24
12,0,11,8;77,78,79;55,54,53,52,64,76,88,89,90,91,92,93,105,117,129;65,66,67;126,125,124,123,122,121,109,97,85,73,61,49,37,25,13,14,15,16,17,18,19,20,32,33,45,57,69,70,82,94,106,118,130;31,30,29,28,27,26,38,50,62,74,86,98,110,111,112,113,114,115,127,139,140,141;142,143,131,119,107,95,83,71,59,58,46,34,22,21,9,8,7,6,5,4,3,2,1,0,12,24,36,48,60,72,84,96,108,120,132,133,134,135,136,137,138;10,11,23,35,47;128,116,104,103,102,101,100,99,87,75,63,51,39,40,41,42,43,44,56,68,80,81
11,0,12,8;83,84,73,62,51,40,39,38,37,36,35,34,33;88,77,78,67,56,57,58,59,60;91,102,101,100,99;66,55,44,45,46,47,48,49,50,61,72,71,82,93,94,95,106,107,108,97,86,75,64,53,42,31,20,19,18,17,16,15,14,13,12,11;115,114,113,112,111,110;80,81,92,103,104,105,116,117,118,119,120,109,98,87,76,65,54,43,32,21,10,9,8,7,6,5,4,3,2,1,0;89,90,79,68,69,70;22,23,24,25,26,27,28,29,30,41,52,63,74,85,96
10,0,13,4;66,65,64,63,53,43,33,23,13,3,4,5,6,7;8,18,17,16,15,14,24,34,44,54,55,56,57,67,77,76,75,74,73,72,62,52,42,32,22,12,2;10,20,30,40,50,60,70,80,90,91,92,93,94,95,96,97,98,99,89,79,69,59,49,39,38,37,36;9,19,29,28,27,26,25,35,45,46,47,48,58,68,78,88,87,86,85,84,83,82,81,71,61,51,41,31,21,11,1,0
11,0,14,7;109,120,119,118,117,116;58,47,36,25,26,27,28,29,30,41,52,63,74,73,84;114,115,104,105,106,107,108,97,98,87,76,65,54,43,32,21,10,9,8,7,6,5,4,3,2,1,12,23,34,45,56,67,66,77,88,99,110,111;83,72,61,62,51,40,39,38,37,48,59,70,69,80,91,90,101;112,113,102,103,92,93,94,95,96,85,86,75,64,53,42,31,20,19,18,17,16,15,14,13,24,35,46,57,68,79,78,89,100;55,44,33,22,11,0;81,82,71,60,49,50
12,0,15,10;21,33,45,57,56,68,80,79;55,54,53,65,77,89,101,100,99;19,7,6,5,4,3,2,1,0,12,24,36,37,38,39,40,52,64,76,88,87,86,98,110,111,112,113,114,102,103;25,13,14,15,16,17,18,30,31,32,20,8,9,10,11,23,35,47,59,71;26,27,28,29,41,42,43,44;22,34,46,58,70,69,81,93,94,106;62,61,73,85,97,109,121,122,123,124,125,126,127,115,116;67,66,78,90,91,92,104,105,117,118;74,75,63,51,50,49,48,60,72,84,96,108,120,132,133,134,135,136,137,138,139,140,141,142,143,131,119,107,95,83,82;130,129,128
11,0,16,7;82,81,80;40,51,50,49,38,37,36,47,58,69,70,71,72,83,84;6,17,16,27,26,25,24,35,46,57,68,79,90,91,92,93,94,95,96,85,74,63,52,41,30,19,20,21;43,54,65,76,87,98,109,120,119,118,117,116,115,114,113,112,111,110,99,88,77,66,55,44,33,22,11,0,1,2,3;32,31,42,53,64,75,86,97,108,107,106,105,104,103,102,101,100,89,78,67,56,45,34,23,12,13,14,15,4,5;73,62,61,60,59,48;10,9,8,7,18,29,28,39
10,0,17,6;11,1,2,3,4,5,6,16,26,36,46,56;0,10,20,30,31,32,33,43;18,28,38,48,58,68,78,77,76,75,74,73,72;80,90,91,92,93,94,95,96,97,98,99,89,79,69,59,49,39,29,19,9,8,7,17,27,37,47,57,67,66,65,55,45,35,25,15,14,13,12,22,21;88,87,86,85,84,83,82,81,71,70,60,50,40,41,42,52,53,54,44,34,24,23;51,61,62,63,64
11,0,18,8;61,60,59,48,37,36;39,50,49;110,111,112,113,114,115,116,117,118,119,120,109,98,87,76,65,54,43,42,41;107,108,97,86,75,64,63,62,73,72,71,70,69,58,47,46,35,24,25,26,15,16,17,18,19,30,31,32,21,10;14,13,12,23,34,45,56,57,68,79,80,81,82;84,83,94,93,92,91,90,89,78,67,66,55,44,33,22,11,0,1,2,3,4,5,6,7,8,9,20;77,88,99,100,101,102,103,104,105,106,95,96,85,74;53,52,51,40,29,28,27,38
12,0,19,7;58,70,82,94,106,118,130,129,141,140,139,138,137,136,135,134,133,132,120,108,96,84,72,60,48,36,24,12,0,1,2,3,4,5,6,7,8,9;11,23,35,34,33,32,31,30,29,28,27,26,38,50,62,74,75,76,64,52,53,54,55,56,57,69,81,93,105,117;78,79,91,103,115,114,113,125,124,123,122,121,109,97;126,127,128,116,104,92,80,68,67,66,65,77,89,88,87,99;63,51,39,40,41,42,43,44,45,46,47,59,71;10,22,21,20,19,18,17,16,15,14,13,25,37,49,61,73,85,86,98,110,111,112,100,101,102,90;83,95,107,119,131,143,142
11,0,20,5;99,100,101,102,103,92,81,70,59,58,47,36,37,38,39,50,61,72,83,94,105,116,117,118,119,120,109,98,87,76,65,54,43,32,21,10;110,111,112,113,114,115,104,93,82,71,60,49,48;79,78,67,56,45,34,23,12,13,14,15,16,17,18,19,30,41,52,63,74,85,96;8,7,6,5,4,3,2,1,0,11,22,33,44,55,66,77,88,89,90;91,80,69,68,57,46,35,24,25,26,27,28,29,40,51,62,73,84,95,106,107,108,97,86,75,64,53,42,31,20,9
10,0,21,5;89,88,87,86,85,84,83,73,63,53,43,33,34,35,45,55,65,66,67,68,58,48,47,37,27;57,56,46,36,26,25,24,23,22,32,42,52,62,72,82,92,93,94,95,96,97,98,99;44,54,64,74,75,76,77,78;38,28,18,17,16,15,14,13,12,11,21,31,41,51,61,71,81,91;79,69,59,49,39,29,19,9,8,7,6,5,4,3,2,1,0,10,20,30,40,50,60,70,80,90
11,0,22,5;60,61,72,73,74,75,86,97,98,109;120,119,118,117,116,115,114,113,112,111,110,99,88,77,66,55,44,33,22,11,0,1,2,3,4,5,6,7,8,9,10,21,32,43,54,53,52,51,50,49,48,59,70,71,82,83,84,85;62,63,64,65,76,87;108,107,96,95,94,93,92,91,90,79,68,57,46,35,24,25,26,27,28,29,30;106,105,104,103,102,101,100,89,78,67,56,45,34,23,12,13,14,15,16,17,18,19,20,31,42,41,40,39,38,37,36,47,58,69,80,81
12,0,23,9;68,56,55,54,66,78,77,76,75,87,99,111,110,109,108,120,132,133,134,135,136,137,125,113,101,102,103,104;2,1,0,12,24,25,26,27,28,40,52,51,50,49,61,73,85;93,94,82,70,58,46,34,33,32,31,30,29;13,14,15,3,4,5,6,7,8,9,10,11,23,35,47,59,71,83,95,107,119,131,143,142,141,140,139,138,126,114,115,116,117,105;22,21,20,19,18,17,16;74,62,63,64,65,53,41,42,43,44,45,57,69,81,80,92;86,98,97,96,84,72,60,48,36,37,38,39;67,79,91,90,89,88,100,112,124,123,122,121;127,128,129,130,118,106
11,0,24,7;43,54,65,76,87,98,109,120,119,118,117,116,115,114,113,112,111,100,89,78,67,68,57;53,42,31,32,21,10,9,8,7,6,5,4,3,2,1,0;56,45,34,23,24,25,26,27,28,39,50,61,72,83,84;81,70,59,48;46,47,58,69,80,79,90,101,102,103,104,105,106,107,108,97,86,75,64,63,52,41,30,19,20;110,99,88,77,66,55,44,33,22,11,12,13,14,15,16,17,18,29,40,51,62,73,74,85,96,95,94;35,36,37,38,49,60,71,82,93,92,91
10,0,25,5;72,62,52,42,32,22,23,24,25,26,27,37,47,57,67,68,69,79;88,78,77,76,66,56,46,36,35,34,33,43,53,63,73,83,82,81,71,61,51,41,31,21,11,12,13,14,15,16,17,18,28,38,48,58;96,95,94,93,92,91,90,80,70,60,50,40,30,20,10,0,1,2,3,4,5,6,7,8,9,19,29,39,49,59;84,74,64,54;89,99,98,97,87,86,85,75,65,55,45,44
11,0,26,9;112,111,110,99,88,77,66,55,44,45,46,47,48,59,60;0,11,22,33,34,35,36,37,38,49;96,95,94,93,92,91,90;9,10,21,32,43,54,65,76,87,98,109,120,119,118,117,116,115;3,2,1,12,23,24,25,26,27,16,17,18,29,30,41,52,63,74,85,84,83,82,81,80,79,68,67;114,103,104,105,106,107,108,97,86,75,64,53,42,31,20,19,8,7,6,5,4,15,14,13;28,39,40,51,62,73;113,102,101,100,89,78;56,57,58,69,70,71,72,61,50
12,0,27,7;38,39,27,15,3,4,5,6,7,8,9,21,33,45,57,69,81,93,105,117,116,115,114,113,112,111;11,10,22,34,46,58,70,82,94,106,118,130,129,128,127,126,125,124,123,122,121,109,97,85,86,87,88,89,90,91,79,67,55,43,31,30,29,41,53,65,64,63,62,61,49,37;110,98,99,100,101,102,103,104,92,80,68,56,44,32,20,19,18,17,16,28,40,52,51,50;23,35,47,59,71,83,95,107,119,131,143,142,141,140,139,138,137,136,135,134,133,132,120,108,96,84;26,25,13,12,0;42,54,66,78,77,76,75,74,73,72,60,48,36,24;14,2,1
11,0,28,7;46,45,34,23,12,13,14,25,26,37,38,39,40,51,62,61,72;24,35,36,47,48,49,50;85,96,95,94,93,82,71,60,59,58,57,56,67,78,89,100,111;113,112,101,90,79,68,69,70,81,92,103,104,105,106,107,108,97,86,75,64,53,42,31,20,19,18,17,6,5,4,3,2,1,0,11,22,33,44,55,66,77,88,99,110;80,91,102;114,115,116,117,118,119,120,109,98,87,76,65,54,43,32,21,10,9,8,7;83,84,73,74,63,52,41,30,29,28,27,16,15
10,0,29,9;23,24,25,26,36,46;72,71,61,51,41,31,30,20,10,0,1,2,3,4,5,6,16,17;11,21,22,32,33,34,35,45,55,56,57,47,37,27,28,18;38,48,58,68,67,66,65,64,54,44,43,42,52,62;90,91,92,93,94,95;87,77,76,75,74,73,63,53;89,99,98,97,96,86,85,84,83,82,81,80,70,60,50,40;15,14,13,12;7,8,9,19,29,39,49,59,69,79,78,88
11,0,30,7;84,73,62,51,40,39,38,37,36,35,34;56,67,68,69;45,46,47,48,49,50,61,72,83,94,95,96,85,74,63,52,41,30,29,28,27,26,25,24,23,22,33;60,71,82,93,92,91,90;88,89,100,101,102,103,104,105,106,107,108,97,86,75,64,53,42,31,20,19,18,17,16,15,14,13,12,11,0;44,55,66,77,78,79,80,81,70,59,58,57;99,110,111,112,113,114,115,116,117,118,119,120,109,98,87,76,65,54,43,32,21,10,9,8,7,6,5,4,3,2,1
